9800002000000000000000000
0000002000000000000000000
0000002000000000000000000
0000002000000000000000000
0000002000000000000000000
2222000000000000000000000
0000000000000000000000000
0000000000000000000000000
0000000000000000000000000
0000000000000000000000000
0000000000000000000000000
0000000000000000000000000
0000000000022222222222222
0000000000020000000000000
0000000000020011111111111
0000000000020000000000000
0000000000020011111111111
0000000000020000000000000
0000000000020011111111111
0000000000000000000000000
