1111111111111111111111111
0000101100000111000000001
0000000110001110000000000
0002000000000000011111100
0000000011111111110000011
0001100111000000000000000
1111100000000000010100000
0000000001111111100000000
0000011111111000000011111
0000000000000111100000000
0001111000000000000111111
0000000000111111111110000
1111111001111111111111111
1111111001100000000000000
0000000000000000000000000
1111111001111111111111111
0000000000000000000000000
1111111001111111111111111
0000000000000000000000000
1111111111111111111111111