9900002000000330077005500
9900002000000000000000000
0000002000000000000000000
0000002000000000000000000
0000002000000000000000000
2222000000000000000222002
0000000000000000000200000
0000000000000000000200000
0000000000000000000200000
0000000000000000000200000
0000000000000000000200099
0000000000000000000200099
0000000000022222222222222
0000000000020000000000000
0000000000020011111111111
0000000000020000000000000
0000000000020011111111111
0000000000020000000000000
0000006000020011111111111
0000000000000000000000000
